7
$       ##         $ 
        #        **  
     # $    ~~ ++**~*
 *~~*#++++ #~~*++*~~*
+*~~*#++++##~~*++*~~*
+*~~**~~~~##~**++ ~**
++~~*** ~~ ***    $* 
$**++ *++$++*++ ##+++
#  ++  ++ ++*++ ##+++
##*++++++ ++ ++*##++*
#**++++++ ++ ++***++*
 **++  ++ ++ ++++*++*
***++  ++ ++ ++++**+*
 **   **** *** ******
 ##~~~##*+++*  ***   
 ##~~~##*+++*#++*~~~ 
 ##~~~##*+++*#++#~~~*
* # ~~  ****##++#~~**
**       **  #++*+ **
 ***++   +++   **+++*
 ****+   +@+    ** **
fsHSHfSSHfHHfHsS