7
$     ++       $     
  ## # ###      +    
  #*## #***  ++++++++
  #**#*#*##   ++ +++ 
      *###  ~~ ++ +  
 **  $***** ~~$ ++   
 **+ ++**+++~~~+++###
 **+ ++  ++++     ###
$ ++ ++++++~** **    
 + + ++++++~** **++  
  ~~ ++  ++ ** **++  
++~~~++  ++ *****+  $
+~~~~  ~~~~+  ++++###
++~~~  ##~~++ +++ ## 
++~~~  ###      +    
      + ++#+         
# +++##+   +#++      
#**+**    ## #++##++ 
 **+**  ##     *#    
 *++*    +++   ++    
   +     +@+         
sSHHfSsHsfSHHsfHsfH