6
$         $         $
 +++ +++ +++ +++ +++ 
*********************
#*###*###*###*###*#*#
*********************
 +++ +++ +++ +++ +++ 
                     
 ~~ + + + + + + + ~~ 
 ~~ + + + + + + + ~~ 
$   + + + + + + +   $
+++ + + + + + + + +++
##+***************+##
++***#*#*#*#*#*#***++
***#*************#***
 + # + + + + + + # + 
 + # + + +#+ + + # + 
 + # + + +#+ + + # + 
 + # + + + + + + # + 
 + # + +     + + # + 
 + # + + +++ + + # + 
         +@+         
sSHsfSssHSssHssf