6
$   ## ## $ ## ##   $
 ++       +       ++ 
 ++ ++ ++ + ++ ++ ++ 
             ***     
+# + #+ #+ +#*+#*+ #+
+# + #+ #+ +#*+#*+ #+
+# + #+ #+ +#*+#*+ #+
+# + #+ #+ +#*+#*+ #+
****         ****    
*++*## ++ # ++ ## ++ 
*****                
 ~*~~*~~*~*~*~~*~~*~*
 ~*~~*~~*~*~*~~*~~*~*
$       *****     **$
##*#*##*#*#*##*#*#*##
   *  *  * *  * * * *
*++ ++ ++ + ++ ++ ++*
*++ ++ ++ + ++ ++ ++*
****             ****
*+++++ # +++ # +++++*
         +@+         
ssSsHssSSsssHssSsf