6
$ ***     $   ***** $
 + +*+ + + + +*+*+*+ 
  ****        *****  
# # # # # # # # # # #
**   *****       *** 
*~*~ ~*~*~ ~ ~ ~ ~*~ 
**   *****       *** 
+ # # # # # # # # # +
+ # # # # # # # # # +
              *****  
$+ + + + + + +*+*+ +$
##            **** ##
++ # # # #*# # # # ++
***# # # #*# # # #***
***     *****     ***
 ++ + + +*#*+ + + ++ 
        *****        
 # # # # # # # # # # 
 # # # #     # # # # 
 # # # # +++ # # # # 
         +@+         
ssHsssHssHfSsSsS