6
$        $    ++  $  
 **++  ++*  ***+ **  
 **++* +**~~##*+**** 
  # #**+**~~#*  ##*  
 ## ###$~~~~ **$##   
 #~  #* ~~+++*#*~~~**
  ~~~** ## ++## +~~*+
  ~~~~*~## ++## ++~*+
   **+*~##   ##      
###**++++ ##*** *    
    **+++ ##*** **###
 ++~~**## * **+ #+   
 ++~~~*## **+++ ##~**
 ++ ~~*+## *+++ #~~ *
 +## ~~     +++ ~~++ 
  ##     +++*     ++ 
 ** #*## ##++*### ++#
***##***+   +*###++##
**###**+*    **##*** 
   ++  * +++    +    
   ++    +@+    **+  
sHSHfsSHHfHssHHSs