7
$        $          $
  ++  ++**++*++*++ + 
* ++  ++**++*++*++ + 
**++++++**++*+++++ + 
**++++++**++*+++++ + 
**++  ++**++*++ ++ + 
**++  ++**++*++ ++ + 
        ~#           
$ ##   $~~  ~~      $
# #++ ##~~  ~~  ++  #
# #++ ##~~  ~++ ++ ##
 **++ ##~~## ++ ++ **
 **~~*** ### ++ ++ **
*++~~++****~*++    * 
*++ ~++~**~~**    ++*
**## ++~ +~~+ ### ++*
**## ++~+#+++*###*++*
*++#    +##++*+##****
 ++ ++       **++  ++
 ++ ++   +++  +++* ++
    +    +@+    ***  
sHSHfSSSHfsHHfSsH

