6
$         $        $ 
 + + + ++ + ++ + + + 
 + + + ++ + ++ + + + 
 + + + ++ + ++ + + + 
 + + + ++#+#++ + + + 
 + + + ++ + ++ + + + 
 + + +         + + + 
 + + + +++ +++ + + + 
$                   $
+++ + +       + + +++
##+ + + ++ ++ + + +##
                     
 + + +         + + + 
 + + + ++ + ++ + + + 
 + + + +++++++ + + + 
 + + + ++ + ++ + + + 
 + + + ++ + ++ + + + 
 + + + ++ + ++ + + + 
 + + +         + + + 
 + + +   +++   + + + 
         +@+         
sfHSssHsssssSHs
