7
$            ++     $
  ##      $  *+      
  ## ++~#### *+ ##   
  ## ++~#### ***##**+
++##*++~~~~*++~ ##*++
+*##**~~~~~*++~~##*++
+*## **+~#**++~~##*++
**** **++#**         
****###+### **## +** 
$ *+###$ ~~****# +**$
## ++  ~~~~++ ** #+ #
   ~  ~~~~~++ **~#++#
   ~##  +***##+~~    
++~~##  +**~##+~~    
++ +##**+*~~## +##** 
++ +##**++~~## +###**
 * +##*+ +++## #####*
 ** # +++ *****++ ***
 **##  ++    **## ***
  *++    +++ **++ *  
   ++    +@+   +     
sSSfHHSfsHfsSHHfsH
