6
$         $        $ 
 + # # # # # # # # + 
 + # # # # # # # # + 
 +******** ********+ 
 +*~~*~~~*~*~~~*~~*+ 
  ******** ********  
  + + + + # + + + +  
  + + + + # + + + +  
$   + + + # + + +   $
+++ + + + # + + + +++
##+       #       +##
    ### #   # ###    
 ++     #+#+#     ++ 
 ++ ### #   # ### ++ 
 ++               ++ 
 ++ ++ + + + + ++ ++ 
 ++ ++ + + + + ++ ++ 
 ++ ++ + + + + ++ ++ 
 ** ++ +     + ++ ** 
 ~~ ++ + +++ + ++ ~~ 
         +@+         
ssSsfssfHsssfssH