6
  $*******$*******$  
*# **~~~~~~~~~~~** #*
**  **~~~~~~~~~**  **
***# **~~~~~~~** #***
*#** $**~~~~~**$ **#*
*****# **~~~** #*****
***#**  **~**  **#***
*******# *** #*******
*****#**  *  **#*****
********** **********
 ######## # ######## 
                     
# # # # ##### # # # #
* #  ***********  # *
** #  *********  # **
*** #  *******  # ***
**** #  *****  # ****
***** #  ***  # *****
****** #  *  # ******
*******  +++  *******
******** +@+ ********
sssHssSffSSssHsssS