6
$   ++   ++   * *$   
  **+   +***   ***   
 ***+   +**~~~ +++***
##++     +*~~~ +#+###
### ++***+   $ #+#   
    $****+           
+##  *~~+*###++ ~~***
+##  ~~~+*##++#+~~**+
     ~~~+*++++#+~~**+
   # ~~~+*+####***   
$ ###     ##    *    
++ #** +###   ++#### 
+~~~** +++++**++##   
+*~#    ++++**+ ##   
*** ~~+ +##~**    ** 
*** ~~+ +  ~~~~  **+ 
*** +++      +~  ###*
 #### +   ## +   +++*
 #**    ##   ++  ++**
 ##++    +++ ++   ++*
   ++    +@+   +    +
sfHsHSHfsHsSHfs